* P W * - *
+ - - - + -
- - - - S *
- + - - - ^
- - - * * -
* - + E - *