* * - - - S - - - ^
- - - - + - - * - -
+ W - - - - - - * -
P - - - * * - - - E
* - - - + - * W * +
- - * - - - - * W +
- - * - - * - - - -
W - - - - - - - * -
- * - + - - - * - *
- - - - - ^ - - - ^