- - P - - + * * S E
- - - * - - - ^ - W
- - * - - + - W + *
* - * * - - - * - -
- * - * * - - - * -
- - * - - + - * - +
- - - - W - - - - -
* - * - - - - - - *
- - - - * - ^ - * -
- - * * - - * - - W