- * - P - - - * - - + -
- - - - * - * - - * - -
* - * - - - * - - - W -
* - - - - - - - * - - *
- - - - + - - - + - + -
- - - - - - - - - * - -
* - - - * - * S - - - -
+ - - - * - + - - - ^ -
- - - ^ - - - - - * - -
- - - - - - * - - W - -
* - - * - - - - W - - W
- - * - - - - - * - * E