* - * - * S
- + - - * *
* - P - - -
^ - - - - -
* - - + - *
E * - - ^ *