P - - + * S - - - - - * W -
- W - * - + - - - - E * * -
- - * - W - - - - + - - * *
+ - - - - - - - - - - - - *
W - - - * - + - - - - - - -
+ - - * - * W - - - - - * -
- - W - - - + - - - - - - -
+ - * W - - - - - * - - * -
- - - * - - - W - - - * - -
+ - - - * - - * W - * - - -
- * * - + - - - - - W * - -
- - - - - W - * - * - - + -
- - + - - * - - - * - - - *
- - - - - - + - - - - * - -
