- - - * - * + - - P
- * - - - - * - - -
* - - T - * - - - -
- - - - - - - * T *
T - - * - * - - - -
- - - - - T - - - *
- * - - * - * - - T
- - T - * B - + - -
* - - - T - * - - -
- - * - - + - - - *